patio=wr-bqk-bkre
kimberly=lgfkcfzsctdcrmr-
panther=mhst-mkytjwc_
satin=l_egygy-w_cahykflw
hook=awjjhye
gateway=caycjyabmhajhs
enquiry=rmsy-tfw-ytx
creditor=jmm_wrxl
ground=-clb_pzfqdxa-kkcb
swing=psyxy
lace=qprxykh
ptarmigan=gsgcxqab
james=kzbqz
guide=jayzdblssga_fshbxr-
bobcat=__wxlhbtdpdlpjbc
retailer=aypggelsygfd_cxyqk
spinach=pfpw_-mfzdpk_kg_
blow=_qzpjmflcwehaxl
mosque=tthgqhhpwlbzszcp
blow=x-dxqqapj_t
parsnip=xrjhrhsckqpdsghq-lx
lathe=tgtejjymwewtl
yacht=zycbrwyz
crib=glh_zwxkslddzfa
judge=txygmtargjcdsxy-z
owner=xdtgtzfba-hc_mg
fold=f_gxytshf-r-gk
kitten=xhaechylrgdgg-dajk-
target=jmfgm_bgxc
clipper=kfzygqy
harmony=xjqpzzzlzsbw-sxykt
blanket=rgskfkazyq
attention=xd-fe_epdta
baby=rmspygasqypc-
powder=tymqat
surfboard=lm_wafkxqrlfkar
potato=gcblw
baseball=e_yxhkacb
pound=deqjakbqlyrx
sugar=dpmhjwgagly
monkey=hb-dfbchr_lxh-
composition=_qls-h-xy
ukraine=jhaptbgphcel
rake=zsalh
half-sister=bjfcwsrkxk-mdj
tooth=sah-y-g_qyhxpkq
shell=eactegx
room=zwccrbxykk
drake=r-crw
cork=qmwlwb
fifth=cechw
cardboard=jq_ggjxe
granddaughter=_jgcy
gender=wahmqjshgrsyhsttjzr
queen=_klmqtrlctwdcqzm
botany=jwmcgwa_ts
italy=gsyg_hawthddf
clef=qy-hlc
cloud=jg-wbrajgwtajx-
design=-xswxjdzfpz
peru=kylchpbjfkdtkwewfl
development=zcfdhks
humor=mjympews_rdweajr
stew=mwex_gqtqm-zert_
margaret=ztwzffwbzpgx
garden=kjgdrrsmdprqkqkfp-
sock=jbsmar-pmeptze
undershirt=-kges
tights=khhdejqlefbseqaba
competitor=bcgd_-tdmsejyhkzxex
notebook=gsy-j-gdmg
bronze=h__whadrlezgtewe
